28,28,28,28,28,28,28,28,28,28,28,28,28,28,28
28,28,1,3,18,15,26,15,19,1,3,44,1,44,28
28,1,1,3,16,3,28,1,16,34,1,1,47,44,28
28,34,34,18,20,28,28,28,16,1,2,1,16,44,28
28,1,1,16,34,28,28,28,16,34,2,34,16,1,28
28,39,15,20,34,28,28,3,21,15,15,15,23,34,28
28,39,42,1,1,1,1,3,3,1,28,28,27,28,28
28,28,39,39,1,1,1,1,1,1,28,1,16,1,28
28,28,28,28,2,2,2,3,34,1,26,15,20,1,28
28,28,28,28,28,28,28,28,28,28,28,28,28,28,28
